topology.script.file.name	net.topology.script.file.name
topology.script.number.args	net.topology.script.number.args
hadoop.configured.node.mapping	net.topology.configured.node.mapping
topology.node.switch.mapping.impl	net.topology.node.switch.mapping.impl
dfs.df.interval	fs.df.interval
hadoop.native.lib	io.native.lib.available
fs.default.name	fs.defaultFS
dfs.umaskmode	fs.permissions.umask-mode
dfs.nfs.exports.allowed.hosts	nfs.exports.allowed.hosts
dfs.backup.address	dfs.namenode.backup.address
dfs.backup.http.address	dfs.namenode.backup.http-address
dfs.balance.bandwidthPerSec	dfs.datanode.balance.bandwidthPerSec
dfs.data.dir	dfs.datanode.data.dir
dfs.http.address	dfs.namenode.http-address
dfs.https.address	dfs.namenode.https-address
dfs.max.objects	dfs.namenode.max.objects
dfs.name.dir	dfs.namenode.name.dir
dfs.name.dir.restore	dfs.namenode.name.dir.restore
dfs.name.edits.dir	dfs.namenode.edits.dir
dfs.read.prefetch.size	dfs.client.read.prefetch.size
dfs.safemode.extension	dfs.namenode.safemode.extension
dfs.safemode.threshold.pct	dfs.namenode.safemode.threshold-pct
dfs.secondary.http.address	dfs.namenode.secondary.http-address
dfs.socket.timeout	dfs.client.socket-timeout
fs.checkpoint.dir	dfs.namenode.checkpoint.dir
fs.checkpoint.edits.dir	dfs.namenode.checkpoint.edits.dir
fs.checkpoint.period	dfs.namenode.checkpoint.period
heartbeat.recheck.interval	dfs.namenode.heartbeat.recheck-interval
dfs.https.client.keystore.resource	dfs.client.https.keystore.resource
dfs.https.need.client.auth	dfs.client.https.need-auth
slave.host.name	dfs.datanode.hostname
session.id	dfs.metrics.session-id
dfs.access.time.precision	dfs.namenode.accesstime.precision
dfs.replication.considerLoad	dfs.namenode.replication.considerLoad
dfs.replication.interval	dfs.namenode.replication.interval
dfs.replication.min	dfs.namenode.replication.min
dfs.replication.pending.timeout.sec	dfs.namenode.replication.pending.timeout-sec
dfs.max-repl-streams	dfs.namenode.replication.max-streams
dfs.permissions	dfs.permissions.enabled
dfs.permissions.supergroup	dfs.permissions.superusergroup
dfs.write.packet.size	dfs.client-write-packet-size
dfs.block.size	dfs.blocksize
dfs.datanode.max.xcievers	dfs.datanode.max.transfer.threads
io.bytes.per.checksum	dfs.bytes-per-checksum
dfs.federation.nameservices	dfs.nameservices
dfs.federation.nameservice.id	dfs.nameservice.id
dfs.client.file-block-storage-locations.timeout	dfs.client.file-block-storage-locations.timeout.millis
dfs.encryption.key.provider.uri	hadoop.security.key.provider.path